disease,0,all_samples,1,processed_runs,2,valid_runs,3,failed_runs,4,nr_species,5,nr_genus,6,term,7,note,8
C537163,C537163,30,30,30,30,0,0,30,30,0,0,0,0,Pediatric Autoimmune Neuropsychiatric Disorders Associated with Streptococcal infections,Pediatric Autoimmune Neuropsychiatric Disorders Associated with Streptococcal infections,"OBSESSIVE-COMPULSIVE DISORDER and TIC DISORDERS that occur in children, typically under age 10, and is associated with group A beta-hemolytic Streptococcal infection. Onset occurs rapidly and patients may also exhibit emotional lability; SEPARATION ANXIETY DISORDER; ANOREXIA; and ADDH - like symptoms. AUTOIMMUNITY against proteins in the BASAL GANGLIA may cause this disorder.","OBSESSIVE-COMPULSIVE DISORDER and TIC DISORDERS that occur in children, typically under age 10, and is associated with group A beta-hemolytic Streptococcal infection. Onset occurs rapidly and patients may also exhibit emotional lability; SEPARATION ANXIETY DISORDER; ANOREXIA; and ADDH - like symptoms. AUTOIMMUNITY against proteins in the BASAL GANGLIA may cause this disorder."
D000066891,D000066891,81,81,0,0,0,0,0,0,0,0,0,0,Critical Care Outcomes,Critical Care Outcomes,A measure of the mortality and morbidity rates among patients who receive CRITICAL CARE and INTENSIVE CARE as determined from the date of hospital discharge or release.,A measure of the mortality and morbidity rates among patients who receive CRITICAL CARE and INTENSIVE CARE as determined from the date of hospital discharge or release.
D000067011,D000067011,46,46,46,46,46,46,0,0,1717,1717,663,663,Severe Acute Malnutrition,Severe Acute Malnutrition,"Acute form of MALNUTRITION which usually affects children, characterized by a very low weight for height (below -3z scores of the median World Health Organization standards), visible severe wasting, or occurrence of nutritional EDEMA.  It can be a direct or indirect cause of fatality in children suffering from DIARRHEA and PNEUMONIA. Do not confuse with starvation, a condition in which the body is not getting enough food, usually for extended periods of time.","Acute form of MALNUTRITION which usually affects children, characterized by a very low weight for height (below -3z scores of the median World Health Organization standards), visible severe wasting, or occurrence of nutritional EDEMA.  It can be a direct or indirect cause of fatality in children suffering from DIARRHEA and PNEUMONIA. Do not confuse with starvation, a condition in which the body is not getting enough food, usually for extended periods of time."
D000067877,D000067877,1217,1217,710,710,606,606,104,104,2325,2325,796,796,Autism Spectrum Disorder,Autism Spectrum Disorder,"Wide continuum of associated cognitive and neurobehavioral disorders, including, but not limited to, three core-defining features: impairments in socialization, impairments in verbal and nonverbal communication, and restricted and repetitive patterns of behaviors. (from DSM-V)","Wide continuum of associated cognitive and neurobehavioral disorders, including, but not limited to, three core-defining features: impairments in socialization, impairments in verbal and nonverbal communication, and restricted and repetitive patterns of behaviors. (from DSM-V)"
D000069279,D000069279,28,28,0,0,0,0,0,0,0,0,0,0,Drug Resistant Epilepsy,Drug Resistant Epilepsy,Epileptic condition in which adequate trials of two tolerated and appropriately chosen and used ANTIEPILEPTIC DRUGS schedules to achieve sustained seizure freedom failed.,Epileptic condition in which adequate trials of two tolerated and appropriately chosen and used ANTIEPILEPTIC DRUGS schedules to achieve sustained seizure freedom failed.
D000077192,D000077192,21,21,0,0,0,0,0,0,0,0,0,0,Adenocarcinoma of Lung,Adenocarcinoma of Lung,"A carcinoma originating in the lung and the most common lung cancer type in never-smokers. Malignant cells exhibit distinct features such as glandular epithelial, or tubular morphology. Mutations in KRAS, EGFR, BRAF, and ERBB2 genes are associated with this cancer.

Year introduced: 2019 (2009)","A carcinoma originating in the lung and the most common lung cancer type in never-smokers. Malignant cells exhibit distinct features such as glandular epithelial, or tubular morphology. Mutations in KRAS, EGFR, BRAF, and ERBB2 genes are associated with this cancer.

Year introduced: 2019 (2009)"
D000077733,D000077733,58,58,58,58,58,58,0,0,317,317,105,105,Immunoglobulin G4-Related Disease,Immunoglobulin G4-Related Disease,"A spectrum of systemic autoimmune diseases in which IMMUNOGLOBULIN G4 plays a pathophysiologic role. It can affect multiple organs in highly variable presentations, characterized by inflammatory lesions composed of IgG4-positive PLASMA CELLS, further infiltrated by T helper cells (T-LYMPHOCYTES, HELPER-INDUCER) when linked to progressive FIBROSIS and eventual organ damage.","A spectrum of systemic autoimmune diseases in which IMMUNOGLOBULIN G4 plays a pathophysiologic role. It can affect multiple organs in highly variable presentations, characterized by inflammatory lesions composed of IgG4-positive PLASMA CELLS, further infiltrated by T helper cells (T-LYMPHOCYTES, HELPER-INDUCER) when linked to progressive FIBROSIS and eventual organ damage."
D000086382,D000086382,328,328,284,284,281,281,3,3,795,795,237,237,COVID-19,COVID-19,2019 Novel Coronavirus Disease,2019 Novel Coronavirus Disease
D000236,D000236,582,582,509,509,359,359,150,150,1673,1673,526,526,Adenoma,Adenoma,A benign epithelial tumor with a glandular organization.,A benign epithelial tumor with a glandular organization.
D000437,D000437,17,17,0,0,0,0,0,0,0,0,0,0,Alcoholism,Alcoholism,"A primary, chronic disease with genetic, psychosocial, and environmental factors influencing its development and manifestations. The disease is often progressive and fatal. It is characterized by impaired control over drinking, preoccupation with the drug alcohol, use of alcohol despite adverse consequences, and distortions in thinking, most notably denial. Each of these symptoms may be continuous or periodic. (Morse & Flavin for the Joint Commission of the National Council on Alcoholism and Drug Dependence and the American Society of Addiction Medicine to Study the Definition and Criteria for the Diagnosis of Alcoholism: in JAMA 1992;268:1012-4)","A primary, chronic disease with genetic, psychosocial, and environmental factors influencing its development and manifestations. The disease is often progressive and fatal. It is characterized by impaired control over drinking, preoccupation with the drug alcohol, use of alcohol despite adverse consequences, and distortions in thinking, most notably denial. Each of these symptoms may be continuous or periodic. (Morse & Flavin for the Joint Commission of the National Council on Alcoholism and Drug Dependence and the American Society of Addiction Medicine to Study the Definition and Criteria for the Diagnosis of Alcoholism: in JAMA 1992;268:1012-4)"
D000544,D000544,219,219,219,219,212,212,7,7,713,713,327,327,Alzheimer Disease,Alzheimer Disease,"A degenerative disease of the BRAIN characterized by the insidious onset of DEMENTIA. Impairment of MEMORY, judgment, attention span, and problem solving skills are followed by severe APRAXIAS and a global loss of cognitive abilities. The condition primarily occurs after age 60, and is marked pathologically by severe cortical atrophy and the triad of SENILE PLAQUES; NEUROFIBRILLARY TANGLES; and NEUROPIL THREADS. (From Adams et al., Principles of Neurology, 6th ed, pp1049-57)","A degenerative disease of the BRAIN characterized by the insidious onset of DEMENTIA. Impairment of MEMORY, judgment, attention span, and problem solving skills are followed by severe APRAXIAS and a global loss of cognitive abilities. The condition primarily occurs after age 60, and is marked pathologically by severe cortical atrophy and the triad of SENILE PLAQUES; NEUROFIBRILLARY TANGLES; and NEUROPIL THREADS. (From Adams et al., Principles of Neurology, 6th ed, pp1049-57)"
D000755,D000755,14,14,14,14,14,14,0,0,137,137,52,52,"Anemia, Sickle Cell","Anemia, Sickle Cell","A disease characterized by chronic hemolytic anemia, episodic painful crises, and pathologic involvement of many organs. It is the clinical expression of homozygosity for hemoglobin S.","A disease characterized by chronic hemolytic anemia, episodic painful crises, and pathologic involvement of many organs. It is the clinical expression of homozygosity for hemoglobin S."
D000855,D000855,147,147,147,147,134,134,13,13,2524,2524,963,963,Anorexia,Anorexia,The lack or loss of APPETITE accompanied by an aversion to food and the inability to eat. It is the defining characteristic of the disorder ANOREXIA NERVOSA.,The lack or loss of APPETITE accompanied by an aversion to food and the inability to eat. It is the defining characteristic of the disorder ANOREXIA NERVOSA.
D000856,D000856,15,15,0,0,0,0,0,0,0,0,0,0,Anorexia Nervosa,Anorexia Nervosa,"An eating disorder that is characterized by the lack or loss of APPETITE, known as ANOREXIA. Other features include excess fear of becoming OVERWEIGHT; BODY IMAGE disturbance; significant WEIGHT LOSS; refusal to maintain minimal normal weight; and AMENORRHEA. This disorder occurs most frequently in adolescent females. (APA, Thesaurus of Psychological Index Terms, 1994)","An eating disorder that is characterized by the lack or loss of APPETITE, known as ANOREXIA. Other features include excess fear of becoming OVERWEIGHT; BODY IMAGE disturbance; significant WEIGHT LOSS; refusal to maintain minimal normal weight; and AMENORRHEA. This disorder occurs most frequently in adolescent females. (APA, Thesaurus of Psychological Index Terms, 1994)"
D001007,D001007,63,63,0,0,0,0,0,0,0,0,0,0,Anxiety,Anxiety,"Feelings or emotions of dread, apprehension, and impending disaster but not disabling as with ANXIETY DISORDERS.","Feelings or emotions of dread, apprehension, and impending disaster but not disabling as with ANXIETY DISORDERS."
D001171,D001171,233,233,233,233,233,233,0,0,0,0,120,120,"Arthritis, Juvenile","Arthritis, Juvenile","Arthritis in children, with onset before 16 years of age. The terms juvenile rheumatoid arthritis (JRA) and juvenile idiopathic arthritis (JIA) refer to classification systems for chronic arthritis in children. Only one subtype of juvenile arthritis (polyarticular-onset, rheumatoid factor-positive) clinically resembles adult rheumatoid arthritis and is considered its childhood equivalent.","Arthritis in children, with onset before 16 years of age. The terms juvenile rheumatoid arthritis (JRA) and juvenile idiopathic arthritis (JIA) refer to classification systems for chronic arthritis in children. Only one subtype of juvenile arthritis (polyarticular-onset, rheumatoid factor-positive) clinically resembles adult rheumatoid arthritis and is considered its childhood equivalent."
D001172,D001172,233,233,233,233,233,233,0,0,438,438,164,164,"Arthritis, Rheumatoid","Arthritis, Rheumatoid","A chronic systemic disease, primarily of the joints, marked by inflammatory changes in the synovial membranes and articular structures, widespread fibrinoid degeneration of the collagen fibers in mesenchymal tissues, and by atrophy and rarefaction of bony structures. Etiology is unknown, but autoimmune mechanisms have been implicated.","A chronic systemic disease, primarily of the joints, marked by inflammatory changes in the synovial membranes and articular structures, widespread fibrinoid degeneration of the collagen fibers in mesenchymal tissues, and by atrophy and rarefaction of bony structures. Etiology is unknown, but autoimmune mechanisms have been implicated."
D001249,D001249,145,145,145,145,145,145,0,0,0,0,132,132,Asthma,Asthma,"A form of bronchial disorder with three distinct components: airway hyper-responsiveness (RESPIRATORY HYPERSENSITIVITY), airway INFLAMMATION, and intermittent AIRWAY OBSTRUCTION. It is characterized by spasmodic contraction of airway smooth muscle, WHEEZING, and dyspnea (DYSPNEA, PAROXYSMAL).","A form of bronchial disorder with three distinct components: airway hyper-responsiveness (RESPIRATORY HYPERSENSITIVITY), airway INFLAMMATION, and intermittent AIRWAY OBSTRUCTION. It is characterized by spasmodic contraction of airway smooth muscle, WHEEZING, and dyspnea (DYSPNEA, PAROXYSMAL)."
D001289,D001289,376,376,376,376,188,188,188,188,2561,2561,879,879,Attention Deficit Disorder with Hyperactivity,Attention Deficit Disorder with Hyperactivity,"A behavior disorder originating in childhood in which the essential features are signs of developmentally inappropriate inattention, impulsivity, and hyperactivity. Although most individuals have symptoms of both inattention and hyperactivity-impulsivity, one or the other pattern may be predominant. The disorder is more frequent in males than females. Onset is in childhood. Symptoms often attenuate during late   adolescence although a minority experience the full complement of symptoms into mid-adulthood. (From DSM-V)","A behavior disorder originating in childhood in which the essential features are signs of developmentally inappropriate inattention, impulsivity, and hyperactivity. Although most individuals have symptoms of both inattention and hyperactivity-impulsivity, one or the other pattern may be predominant. The disorder is more frequent in males than females. Onset is in childhood. Symptoms often attenuate during late   adolescence although a minority experience the full complement of symptoms into mid-adulthood. (From DSM-V)"
D001321,D001321,189,189,189,189,189,189,0,0,2361,2361,849,849,Autistic Disorder,Autistic Disorder,A disorder beginning in childhood. It is marked by the presence of markedly abnormal or impaired development in social interaction and communication and a markedly restricted repertoire of activity and interest. Manifestations of the disorder vary greatly depending on the developmental level and chronological age of the individual. (DSM-V),A disorder beginning in childhood. It is marked by the presence of markedly abnormal or impaired development in social interaction and communication and a markedly restricted repertoire of activity and interest. Manifestations of the disorder vary greatly depending on the developmental level and chronological age of the individual. (DSM-V)
D001327,D001327,1053,1053,1053,1053,553,553,500,500,3095,3095,1016,1016,Autoimmune Diseases,Autoimmune Diseases,Disorders that are characterized by the production of antibodies that react with host tissues or immune effector cells that are autoreactive to endogenous peptides.,Disorders that are characterized by the production of antibodies that react with host tissues or immune effector cells that are autoreactive to endogenous peptides.
D001528,D001528,24,24,24,24,24,24,0,0,212,212,85,85,Behcet Syndrome,Behcet Syndrome,Rare chronic inflammatory disease involving the small blood vessels. It is of unknown etiology and characterized by mucocutaneous ulceration in the mouth and genital region and uveitis with hypopyon. The neuro-ocular form may cause blindness and death. SYNOVITIS; THROMBOPHLEBITIS; gastrointestinal ulcerations; RETINAL VASCULITIS; and OPTIC ATROPHY may occur as well.,Rare chronic inflammatory disease involving the small blood vessels. It is of unknown etiology and characterized by mucocutaneous ulceration in the mouth and genital region and uveitis with hypopyon. The neuro-ocular form may cause blindness and death. SYNOVITIS; THROMBOPHLEBITIS; gastrointestinal ulcerations; RETINAL VASCULITIS; and OPTIC ATROPHY may occur as well.
D001714,D001714,667,667,667,667,445,445,222,222,3034,3034,1002,1002,Bipolar Disorder,Bipolar Disorder,A major affective disorder marked by severe mood swings (manic or major depressive episodes) and a tendency to remission and recurrence.,A major affective disorder marked by severe mood swings (manic or major depressive episodes) and a tendency to remission and recurrence.
D001924,D001924,9,9,0,0,0,0,0,0,0,0,0,0,Brain Concussion,Brain Concussion,"A nonspecific term used to describe transient alterations or loss of consciousness following closed head injuries. The duration of UNCONSCIOUSNESS generally lasts a few seconds, but may persist for several hours. Concussions may be classified as mild, intermediate, and severe. Prolonged periods of unconsciousness (often defined as greater than 6 hours in duration) may be referred to as post-traumatic coma (COMA, POST-HEAD INJURY). (From Rowland, Merritt's Textbook of Neurology, 9th ed, p418)","A nonspecific term used to describe transient alterations or loss of consciousness following closed head injuries. The duration of UNCONSCIOUSNESS generally lasts a few seconds, but may persist for several hours. Concussions may be classified as mild, intermediate, and severe. Prolonged periods of unconsciousness (often defined as greater than 6 hours in duration) may be referred to as post-traumatic coma (COMA, POST-HEAD INJURY). (From Rowland, Merritt's Textbook of Neurology, 9th ed, p418)"
D001943,D001943,152,152,133,133,133,133,0,0,359,359,117,117,Breast Neoplasms,Breast Neoplasms,Tumors or cancer of the human BREAST.,Tumors or cancer of the human BREAST.
D002277,D002277,104,104,104,104,1,1,103,103,118,118,60,60,Carcinoma,Carcinoma,"A malignant neoplasm made up of epithelial cells tending to infiltrate the surrounding tissues and give rise to metastases. It is a histological type of neoplasm and not a synonym for ""cancer.""","A malignant neoplasm made up of epithelial cells tending to infiltrate the surrounding tissues and give rise to metastases. It is a histological type of neoplasm and not a synonym for ""cancer."""
D002318,D002318,508,508,508,508,354,354,154,154,2241,2241,768,768,Cardiovascular Diseases,Cardiovascular Diseases,Pathological conditions involving the CARDIOVASCULAR SYSTEM including the HEART; the BLOOD VESSELS; or the PERICARDIUM.,Pathological conditions involving the CARDIOVASCULAR SYSTEM including the HEART; the BLOOD VESSELS; or the PERICARDIUM.
D002446,D002446,171,171,171,171,66,66,105,105,1106,1106,426,426,Celiac Disease,Celiac Disease,"A malabsorption syndrome that is precipitated by the ingestion of foods containing GLUTEN, such as wheat, rye, and barley. It is characterized by INFLAMMATION of the SMALL INTESTINE, loss of MICROVILLI structure, failed INTESTINAL ABSORPTION, and MALNUTRITION.","A malabsorption syndrome that is precipitated by the ingestion of foods containing GLUTEN, such as wheat, rye, and barley. It is characterized by INFLAMMATION of the SMALL INTESTINE, loss of MICROVILLI structure, failed INTESTINAL ABSORPTION, and MALNUTRITION."
D002763,D002763,28,28,28,28,28,28,0,0,0,0,53,53,Cholecystectomy,Cholecystectomy,Surgical removal of the GALLBLADDER.,Surgical removal of the GALLBLADDER.
D002769,D002769,28,28,28,28,28,28,0,0,0,0,56,56,Cholelithiasis,Cholelithiasis,"Presence or formation of GALLSTONES in the BILIARY TRACT, usually in the gallbladder (CHOLECYSTOLITHIASIS) or the common bile duct (CHOLEDOCHOLITHIASIS).","Presence or formation of GALLSTONES in the BILIARY TRACT, usually in the gallbladder (CHOLECYSTOLITHIASIS) or the common bile duct (CHOLEDOCHOLITHIASIS)."
D003015,D003015,1200,1200,1112,1112,855,855,257,257,3941,3941,1193,1193,Clostridium Infections,Clostridium Infections,Infections with bacteria of the genus CLOSTRIDIUM.,Infections with bacteria of the genus CLOSTRIDIUM.
D003093,D003093,3260,3260,3162,3162,1840,1840,1322,1322,4230,4230,1316,1316,"Colitis, Ulcerative","Colitis, Ulcerative","Inflammation of the COLON that is predominantly confined to the MUCOSA. Its major symptoms include DIARRHEA, rectal BLEEDING, the passage of MUCUS, and ABDOMINAL PAIN.","Inflammation of the COLON that is predominantly confined to the MUCOSA. Its major symptoms include DIARRHEA, rectal BLEEDING, the passage of MUCUS, and ABDOMINAL PAIN."
D003108,D003108,544,544,544,544,361,361,183,183,1422,1422,524,524,Colonic Diseases,Colonic Diseases,"Pathological processes in the COLON region of the large intestine (INTESTINE, LARGE).","Pathological processes in the COLON region of the large intestine (INTESTINE, LARGE)."
D003110,D003110,6,6,0,0,0,0,0,0,0,0,0,0,Colonic Neoplasms,Colonic Neoplasms,Tumors or cancer of the COLON.,Tumors or cancer of the COLON.
D003111,D003111,24,24,0,0,0,0,0,0,0,0,0,0,Colonic Polyps,Colonic Polyps,"Discrete tissue masses that protrude into the lumen of the COLON. These POLYPS are connected to the wall of the colon either by a stalk, pedunculus, or by a broad base.","Discrete tissue masses that protrude into the lumen of the COLON. These POLYPS are connected to the wall of the colon either by a stalk, pedunculus, or by a broad base."
D003248,D003248,1171,1171,1171,1171,665,665,506,506,3157,3157,1016,1016,Constipation,Constipation,"Infrequent or difficult evacuation of FECES. These symptoms are associated with a variety of causes, including low DIETARY FIBER intake, emotional or nervous disturbances, systemic and structural disorders, drug-induced aggravation, and infections.","Infrequent or difficult evacuation of FECES. These symptoms are associated with a variety of causes, including low DIETARY FIBER intake, emotional or nervous disturbances, systemic and structural disorders, drug-induced aggravation, and infections."
D003324,D003324,63,63,0,0,0,0,0,0,0,0,0,0,Coronary Artery Disease,Coronary Artery Disease,"Pathological processes of CORONARY ARTERIES that may derive from a congenital abnormality, atherosclerotic, or non-atherosclerotic cause.","Pathological processes of CORONARY ARTERIES that may derive from a congenital abnormality, atherosclerotic, or non-atherosclerotic cause."
D003424,D003424,2671,2671,2364,2364,1920,1920,444,444,3956,3956,1232,1232,Crohn Disease,Crohn Disease,"A chronic transmural inflammation that may involve any part of the DIGESTIVE TRACT from MOUTH to ANUS, mostly found in the ILEUM, the CECUM, and the COLON. In Crohn disease, the inflammation, extending through the intestinal wall from the MUCOSA to the serosa, is characteristically asymmetric and segmental. Epithelioid GRANULOMAS may be seen in some patients.","A chronic transmural inflammation that may involve any part of the DIGESTIVE TRACT from MOUTH to ANUS, mostly found in the ILEUM, the CECUM, and the COLON. In Crohn disease, the inflammation, extending through the intestinal wall from the MUCOSA to the serosa, is characteristically asymmetric and segmental. Epithelioid GRANULOMAS may be seen in some patients."
D003550,D003550,1262,1262,105,105,79,79,26,26,2158,2158,851,851,Cystic Fibrosis,Cystic Fibrosis,"An autosomal recessive genetic disease of the EXOCRINE GLANDS. It is caused by mutations in the gene encoding the CYSTIC FIBROSIS TRANSMEMBRANE CONDUCTANCE REGULATOR expressed in several organs including the LUNG, the PANCREAS, the BILIARY SYSTEM, and the SWEAT GLANDS. Cystic fibrosis is characterized by epithelial secretory dysfunction associated with ductal obstruction resulting in AIRWAY OBSTRUCTION; chronic RESPIRATORY INFECTIONS; PANCREATIC INSUFFICIENCY; maldigestion; salt depletion; and HEAT PROSTRATION.","An autosomal recessive genetic disease of the EXOCRINE GLANDS. It is caused by mutations in the gene encoding the CYSTIC FIBROSIS TRANSMEMBRANE CONDUCTANCE REGULATOR expressed in several organs including the LUNG, the PANCREAS, the BILIARY SYSTEM, and the SWEAT GLANDS. Cystic fibrosis is characterized by epithelial secretory dysfunction associated with ductal obstruction resulting in AIRWAY OBSTRUCTION; chronic RESPIRATORY INFECTIONS; PANCREATIC INSUFFICIENCY; maldigestion; salt depletion; and HEAT PROSTRATION."
D003863,D003863,569,569,569,569,358,358,211,211,1079,1079,477,477,Depression,Depression,Depressive states usually of moderate intensity in contrast with major depression present in neurotic and psychotic disorders.,Depressive states usually of moderate intensity in contrast with major depression present in neurotic and psychotic disorders.
D003876,D003876,108,108,108,108,0,0,108,108,0,0,0,0,"Dermatitis, Atopic","Dermatitis, Atopic","A chronic inflammatory genetically determined disease of the skin marked by increased ability to form reagin (IgE), with increased susceptibility to allergic rhinitis and asthma, and hereditary disposition to a lowered threshold for pruritus. It is manifested by lichenification, excoriation, and crusting, mainly on the flexural surfaces of the elbow and knee. In infants it is known as infantile eczema.","A chronic inflammatory genetically determined disease of the skin marked by increased ability to form reagin (IgE), with increased susceptibility to allergic rhinitis and asthma, and hereditary disposition to a lowered threshold for pruritus. It is manifested by lichenification, excoriation, and crusting, mainly on the flexural surfaces of the elbow and knee. In infants it is known as infantile eczema."
D003920,D003920,234,234,234,234,124,124,110,110,1911,1911,708,708,Diabetes Mellitus,Diabetes Mellitus,A heterogeneous group of disorders characterized by HYPERGLYCEMIA and GLUCOSE INTOLERANCE.,A heterogeneous group of disorders characterized by HYPERGLYCEMIA and GLUCOSE INTOLERANCE.
D003922,D003922,261,261,261,261,208,208,53,53,324,324,165,165,"Diabetes Mellitus, Type 1","Diabetes Mellitus, Type 1","A subtype of DIABETES MELLITUS that is characterized by INSULIN deficiency. It is manifested by the sudden onset of severe HYPERGLYCEMIA, rapid progression to DIABETIC KETOACIDOSIS, and DEATH unless treated with insulin. The disease may occur at any age, but is most common in childhood or adolescence.","A subtype of DIABETES MELLITUS that is characterized by INSULIN deficiency. It is manifested by the sudden onset of severe HYPERGLYCEMIA, rapid progression to DIABETIC KETOACIDOSIS, and DEATH unless treated with insulin. The disease may occur at any age, but is most common in childhood or adolescence."
D003924,D003924,424,424,424,424,393,393,31,31,4390,4390,1343,1343,"Diabetes Mellitus, Type 2","Diabetes Mellitus, Type 2",A subclass of DIABETES MELLITUS that is not INSULIN-responsive or dependent (NIDDM). It is characterized initially by INSULIN RESISTANCE and HYPERINSULINEMIA; and eventually by GLUCOSE INTOLERANCE; HYPERGLYCEMIA; and overt diabetes. Type II diabetes mellitus is no longer considered a disease exclusively found in adults. Patients seldom develop KETOSIS but often exhibit OBESITY.,A subclass of DIABETES MELLITUS that is not INSULIN-responsive or dependent (NIDDM). It is characterized initially by INSULIN RESISTANCE and HYPERINSULINEMIA; and eventually by GLUCOSE INTOLERANCE; HYPERGLYCEMIA; and overt diabetes. Type II diabetes mellitus is no longer considered a disease exclusively found in adults. Patients seldom develop KETOSIS but often exhibit OBESITY.
D003967,D003967,1264,1264,1256,1256,513,513,743,743,2914,2914,922,922,Diarrhea,Diarrhea,"An increased liquidity or decreased consistency of FECES, such as running stool. Fecal consistency is related to the ratio of water-holding capacity of insoluble solids to total water, rather than the amount of water present. Diarrhea is not hyperdefecation or increased fecal weight.","An increased liquidity or decreased consistency of FECES, such as running stool. Fecal consistency is related to the ratio of water-holding capacity of insoluble solids to total water, rather than the amount of water present. Diarrhea is not hyperdefecation or increased fecal weight."
D004485,D004485,55,55,2,2,2,2,0,0,732,732,248,248,Eczema,Eczema,"A pruritic papulovesicular dermatitis occurring as a reaction to many endogenous and exogenous agents (Dorland, 27th ed).","A pruritic papulovesicular dermatitis occurring as a reaction to many endogenous and exogenous agents (Dorland, 27th ed)."
D004827,D004827,102,102,102,102,42,42,60,60,1051,1051,388,388,Epilepsy,Epilepsy,"A disorder characterized by recurrent episodes of paroxysmal brain dysfunction due to a sudden, disorderly, and excessive neuronal discharge. Epilepsy classification systems are generally based upon: (1) clinical features of the seizure episodes (e.g., motor seizure), (2) etiology (e.g., post-traumatic), (3) anatomic site of seizure origin (e.g., frontal lobe seizure), (4) tendency to spread to other structures in the brain, and (5) temporal patterns (e.g., nocturnal epilepsy). (From Adams et al., Principles of Neurology, 6th ed, p313)","A disorder characterized by recurrent episodes of paroxysmal brain dysfunction due to a sudden, disorderly, and excessive neuronal discharge. Epilepsy classification systems are generally based upon: (1) clinical features of the seizure episodes (e.g., motor seizure), (2) etiology (e.g., post-traumatic), (3) anatomic site of seizure origin (e.g., frontal lobe seizure), (4) tendency to spread to other structures in the brain, and (5) temporal patterns (e.g., nocturnal epilepsy). (From Adams et al., Principles of Neurology, 6th ed, p313)"
D005756,D005756,54,54,0,0,0,0,0,0,0,0,0,0,Gastritis,Gastritis,"Inflammation of the GASTRIC MUCOSA, a lesion observed in a number of unrelated disorders.","Inflammation of the GASTRIC MUCOSA, a lesion observed in a number of unrelated disorders."
D005764,D005764,129,129,129,129,129,129,0,0,1854,1854,758,758,Gastroesophageal Reflux,Gastroesophageal Reflux,"Retrograde flow of gastric juice (GASTRIC ACID) and/or duodenal contents (BILE ACIDS; PANCREATIC JUICE) into the distal ESOPHAGUS, commonly due to incompetence of the LOWER ESOPHAGEAL SPHINCTER.","Retrograde flow of gastric juice (GASTRIC ACID) and/or duodenal contents (BILE ACIDS; PANCREATIC JUICE) into the distal ESOPHAGUS, commonly due to incompetence of the LOWER ESOPHAGEAL SPHINCTER."
D005891,D005891,16,16,16,16,7,7,9,9,399,399,150,150,Gingivitis,Gingivitis,Inflammation of gum tissue (GINGIVA) without loss of connective tissue.,Inflammation of gum tissue (GINGIVA) without loss of connective tissue.
D006086,D006086,33,33,0,0,0,0,0,0,0,0,0,0,Graft vs Host Disease,Graft vs Host Disease,"The clinical entity characterized by anorexia, diarrhea, loss of hair, leukopenia, thrombocytopenia, growth retardation, and eventual death brought about by the GRAFT VS HOST REACTION.","The clinical entity characterized by anorexia, diarrhea, loss of hair, leukopenia, thrombocytopenia, growth retardation, and eventual death brought about by the GRAFT VS HOST REACTION."
D006111,D006111,39,39,39,39,39,39,0,0,1532,1532,550,550,Graves Disease,Graves Disease,"A common form of hyperthyroidism with a diffuse hyperplastic GOITER. It is an autoimmune disorder that produces antibodies against the THYROID STIMULATING HORMONE RECEPTOR. These autoantibodies activate the TSH receptor, thereby stimulating the THYROID GLAND and hypersecretion of THYROID HORMONES. These autoantibodies can also affect the eyes (GRAVES OPHTHALMOPATHY) and the skin (Graves dermopathy).","A common form of hyperthyroidism with a diffuse hyperplastic GOITER. It is an autoimmune disorder that produces antibodies against the THYROID STIMULATING HORMONE RECEPTOR. These autoantibodies activate the TSH receptor, thereby stimulating the THYROID GLAND and hypersecretion of THYROID HORMONES. These autoantibodies can also affect the eyes (GRAVES OPHTHALMOPATHY) and the skin (Graves dermopathy)."
D006130,D006130,233,233,0,0,0,0,0,0,0,0,0,0,Growth Disorders,Growth Disorders,"Deviations from the average values for a specific age and sex in any or all of the following: height, weight, skeletal proportions, osseous development, or maturation of features. Included here are both acceleration and retardation of growth.","Deviations from the average values for a specific age and sex in any or all of the following: height, weight, skeletal proportions, osseous development, or maturation of features. Included here are both acceleration and retardation of growth."
D006262,D006262,34019,34019,23907,23907,16282,16282,7625,7625,6206,6206,1676,1676,Health,Health,The state of the organism when it functions optimally without evidence of disease.,The state of the organism when it functions optimally without evidence of disease.
D006515,D006515,206,206,206,206,206,206,0,0,0,0,36,36,Hepatitis B virus,Hepatitis B virus,"The type species of the genus ORTHOHEPADNAVIRUS which causes human HEPATITIS B and is also apparently a causal agent in human HEPATOCELLULAR CARCINOMA. The Dane particle is an intact hepatitis virion, named after its discoverer. Non-infectious spherical and tubular particles are also seen in the serum.","The type species of the genus ORTHOHEPADNAVIRUS which causes human HEPATITIS B and is also apparently a causal agent in human HEPATOCELLULAR CARCINOMA. The Dane particle is an intact hepatitis virion, named after its discoverer. Non-infectious spherical and tubular particles are also seen in the serum."
D006519,D006519,70,70,0,0,0,0,0,0,0,0,0,0,"Hepatitis, Alcoholic","Hepatitis, Alcoholic","INFLAMMATION of the LIVER due to ALCOHOL ABUSE. It is characterized by NECROSIS of HEPATOCYTES, infiltration by NEUTROPHILS, and deposit of MALLORY BODIES. Depending on its severity, the inflammatory lesion may be reversible or progress to LIVER CIRRHOSIS.","INFLAMMATION of the LIVER due to ALCOHOL ABUSE. It is characterized by NECROSIS of HEPATOCYTES, infiltration by NEUTROPHILS, and deposit of MALLORY BODIES. Depending on its severity, the inflammatory lesion may be reversible or progress to LIVER CIRRHOSIS."
D006678,D006678,236,236,124,124,58,58,66,66,1504,1504,610,610,HIV,HIV,"Human immunodeficiency virus. A non-taxonomic and historical term referring to any of two species, specifically HIV-1 and/or HIV-2. Prior to 1986, this was called human T-lymphotropic virus type III/lymphadenopathy-associated virus (HTLV-III/LAV). From 1986-1990, it was an official species called HIV. Since 1991, HIV was no longer considered an official species name; the two species were designated HIV-1 and HIV-2.","Human immunodeficiency virus. A non-taxonomic and historical term referring to any of two species, specifically HIV-1 and/or HIV-2. Prior to 1986, this was called human T-lymphotropic virus type III/lymphadenopathy-associated virus (HTLV-III/LAV). From 1986-1990, it was an official species called HIV. Since 1991, HIV was no longer considered an official species name; the two species were designated HIV-1 and HIV-2."
D006973,D006973,100,100,100,100,100,100,0,0,266,266,118,118,Hypertension,Hypertension,"Persistently high systemic arterial BLOOD PRESSURE. Based on multiple readings (BLOOD PRESSURE DETERMINATION), hypertension is currently defined as when SYSTOLIC PRESSURE is consistently greater than 140 mm Hg or when DIASTOLIC PRESSURE is consistently 90 mm Hg or more.","Persistently high systemic arterial BLOOD PRESSURE. Based on multiple readings (BLOOD PRESSURE DETERMINATION), hypertension is currently defined as when SYSTOLIC PRESSURE is consistently greater than 140 mm Hg or when DIASTOLIC PRESSURE is consistently 90 mm Hg or more."
D007230,D007230,116,116,116,116,80,80,36,36,1249,1249,423,423,"Infant, Low Birth Weight","Infant, Low Birth Weight","An infant having a birth weight of 2500 gm. (5.5 lb.) or less but INFANT, VERY LOW BIRTH WEIGHT is available for infants having a birth weight of 1500 grams (3.3 lb.) or less.","An infant having a birth weight of 2500 gm. (5.5 lb.) or less but INFANT, VERY LOW BIRTH WEIGHT is available for infants having a birth weight of 1500 grams (3.3 lb.) or less."
D007234,D007234,1443,1443,1443,1443,1279,1279,164,164,260,260,97,97,"Infant, Premature","Infant, Premature",A human infant born before 37 weeks of GESTATION.,A human infant born before 37 weeks of GESTATION.
D007410,D007410,606,606,606,606,337,337,269,269,2157,2157,757,757,Intestinal Diseases,Intestinal Diseases,Pathological processes in any segment of the INTESTINE from DUODENUM to RECTUM.,Pathological processes in any segment of the INTESTINE from DUODENUM to RECTUM.
D007674,D007674,155,155,155,155,66,66,89,89,1328,1328,483,483,Kidney Diseases,Kidney Diseases,Pathological processes of the KIDNEY or its component tissues.,Pathological processes of the KIDNEY or its component tissues.
D007676,D007676,30,30,30,30,30,30,0,0,0,0,94,94,"Kidney Failure, Chronic","Kidney Failure, Chronic","The end-stage of CHRONIC RENAL INSUFFICIENCY. It is characterized by the severe irreversible kidney damage (as measured by the level of PROTEINURIA) and the reduction in GLOMERULAR FILTRATION RATE to less than 15 ml per min (Kidney Foundation: Kidney Disease Outcome Quality Initiative, 2002). These patients generally require HEMODIALYSIS or KIDNEY TRANSPLANTATION.","The end-stage of CHRONIC RENAL INSUFFICIENCY. It is characterized by the severe irreversible kidney damage (as measured by the level of PROTEINURIA) and the reduction in GLOMERULAR FILTRATION RATE to less than 15 ml per min (Kidney Foundation: Kidney Disease Outcome Quality Initiative, 2002). These patients generally require HEMODIALYSIS or KIDNEY TRANSPLANTATION."
D008103,D008103,949,949,437,437,428,428,9,9,2559,2559,935,935,Liver Cirrhosis,Liver Cirrhosis,"Liver disease in which the normal microcirculation, the gross vascular anatomy, and the hepatic architecture have been variably destroyed and altered with fibrous septa surrounding regenerated or regenerating parenchymal nodules.","Liver disease in which the normal microcirculation, the gross vascular anatomy, and the hepatic architecture have been variably destroyed and altered with fibrous septa surrounding regenerated or regenerating parenchymal nodules."
D008104,D008104,1,1,0,0,0,0,0,0,0,0,0,0,"Liver Cirrhosis, Alcoholic","Liver Cirrhosis, Alcoholic",FIBROSIS of the hepatic parenchyma due to chronic excess ALCOHOL DRINKING.,FIBROSIS of the hepatic parenchyma due to chronic excess ALCOHOL DRINKING.
D008107,D008107,168,168,168,168,74,74,94,94,1191,1191,433,433,Liver Diseases,Liver Diseases,Pathological processes of the LIVER.,Pathological processes of the LIVER.
D008108,D008108,3,3,0,0,0,0,0,0,0,0,0,0,"Liver Diseases, Alcoholic","Liver Diseases, Alcoholic","Liver diseases associated with ALCOHOLISM. It usually refers to the coexistence of two or more subentities, i.e., ALCOHOLIC FATTY LIVER; ALCOHOLIC HEPATITIS; and ALCOHOLIC CIRRHOSIS.","Liver diseases associated with ALCOHOLISM. It usually refers to the coexistence of two or more subentities, i.e., ALCOHOLIC FATTY LIVER; ALCOHOLIC HEPATITIS; and ALCOHOLIC CIRRHOSIS."
D008171,D008171,1110,1110,1110,1110,599,599,511,511,2611,2611,873,873,Lung Diseases,Lung Diseases,Pathological processes involving any part of the LUNG.,Pathological processes involving any part of the LUNG.
D008545,D008545,122,122,122,122,105,105,17,17,694,694,221,221,Melanoma,Melanoma,"A malignant neoplasm derived from cells that are capable of forming melanin, which may occur in the skin of any part of the body, in the eye, or, rarely, in the mucous membranes of the genitalia, anus, oral cavity, or other sites. It occurs mostly in adults and may originate de novo or from a pigmented nevus or malignant lentigo. Melanomas frequently metastasize widely, and the regional lymph nodes, liver, lungs, and brain are likely to be involved. The incidence of malignant skin melanomas is rising rapidly in all parts of the world. (Stedman, 25th ed; from Rook et al., Textbook of Dermatology, 4th ed, p2445)","A malignant neoplasm derived from cells that are capable of forming melanin, which may occur in the skin of any part of the body, in the eye, or, rarely, in the mucous membranes of the genitalia, anus, oral cavity, or other sites. It occurs mostly in adults and may originate de novo or from a pigmented nevus or malignant lentigo. Melanomas frequently metastasize widely, and the regional lymph nodes, liver, lungs, and brain are likely to be involved. The incidence of malignant skin melanomas is rising rapidly in all parts of the world. (Stedman, 25th ed; from Rook et al., Textbook of Dermatology, 4th ed, p2445)"
D008881,D008881,1111,1111,1111,1111,568,568,543,543,2450,2450,834,834,Migraine Disorders,Migraine Disorders,"A class of disabling primary headache disorders, characterized by recurrent unilateral pulsatile headaches. The two major subtypes are common migraine (without aura) and classic migraine (with aura or neurological symptoms). (International Classification of Headache Disorders, 2nd ed. Cephalalgia 2004: suppl 1)","A class of disabling primary headache disorders, characterized by recurrent unilateral pulsatile headaches. The two major subtypes are common migraine (without aura) and classic migraine (with aura or neurological symptoms). (International Classification of Headache Disorders, 2nd ed. Cephalalgia 2004: suppl 1)"
D009103,D009103,183,183,40,40,40,40,0,0,0,0,81,81,Multiple Sclerosis,Multiple Sclerosis,"An autoimmune disorder mainly affecting young adults and characterized by destruction of myelin in the central nervous system. Pathologic findings include multiple sharply demarcated areas of demyelination throughout the white matter of the central nervous system. Clinical manifestations include visual loss, extra-ocular movement disorders, paresthesias, loss of sensation, weakness, dysarthria, spasticity, ataxia, and bladder dysfunction. The usual pattern is one of recurrent attacks followed by partial recovery (see MULTIPLE SCLEROSIS, RELAPSING-REMITTING), but acute fulminating and chronic progressive forms (see MULTIPLE SCLEROSIS, CHRONIC PROGRESSIVE) also occur. (Adams et al., Principles of Neurology, 6th ed, p903)","An autoimmune disorder mainly affecting young adults and characterized by destruction of myelin in the central nervous system. Pathologic findings include multiple sharply demarcated areas of demyelination throughout the white matter of the central nervous system. Clinical manifestations include visual loss, extra-ocular movement disorders, paresthesias, loss of sensation, weakness, dysarthria, spasticity, ataxia, and bladder dysfunction. The usual pattern is one of recurrent attacks followed by partial recovery (see MULTIPLE SCLEROSIS, RELAPSING-REMITTING), but acute fulminating and chronic progressive forms (see MULTIPLE SCLEROSIS, CHRONIC PROGRESSIVE) also occur. (Adams et al., Principles of Neurology, 6th ed, p903)"
D009471,D009471,20,20,0,0,0,0,0,0,0,0,0,0,Neuromyelitis Optica,Neuromyelitis Optica,"A syndrome characterized by acute OPTIC NEURITIS; MYELITIS, TRANSVERSE; demyelinating and/or necrotizing lesions in the OPTIC NERVES and SPINAL CORD; and presence of specific autoantibodies to AQUAPORIN 4.","A syndrome characterized by acute OPTIC NEURITIS; MYELITIS, TRANSVERSE; demyelinating and/or necrotizing lesions in the OPTIC NERVES and SPINAL CORD; and presence of specific autoantibodies to AQUAPORIN 4."
D009765,D009765,1250,1250,1019,1019,947,947,72,72,448,448,180,180,Obesity,Obesity,"A status with BODY WEIGHT that is grossly above the acceptable or desirable weight, usually due to accumulation of excess FATS in the body. The standards may vary with age, sex, genetic or cultural background. In the BODY MASS INDEX, a BMI greater than 30.0 kg/m2 is considered obese, and a BMI greater than 40.0 kg/m2 is considered morbidly obese (MORBID OBESITY).","A status with BODY WEIGHT that is grossly above the acceptable or desirable weight, usually due to accumulation of excess FATS in the body. The standards may vary with age, sex, genetic or cultural background. In the BODY MASS INDEX, a BMI greater than 30.0 kg/m2 is considered obese, and a BMI greater than 40.0 kg/m2 is considered morbidly obese (MORBID OBESITY)."
D009767,D009767,8,8,8,8,8,8,0,0,166,166,63,63,"Obesity, Morbid","Obesity, Morbid","The condition of weighing two, three, or more times the ideal weight, so called because it is associated with many serious and life-threatening disorders. In the BODY MASS INDEX, morbid obesity is defined as having a BMI greater than 40.0 kg/m2.","The condition of weighing two, three, or more times the ideal weight, so called because it is associated with many serious and life-threatening disorders. In the BODY MASS INDEX, morbid obesity is defined as having a BMI greater than 40.0 kg/m2."
D010051,D010051,4,4,0,0,0,0,0,0,0,0,0,0,Ovarian Neoplasms,Ovarian Neoplasms,"Tumors or cancer of the OVARY. These neoplasms can be benign or malignant. They are classified according to the tissue of origin, such as the surface EPITHELIUM, the stromal endocrine cells, and the totipotent GERM CELLS.","Tumors or cancer of the OVARY. These neoplasms can be benign or malignant. They are classified according to the tissue of origin, such as the surface EPITHELIUM, the stromal endocrine cells, and the totipotent GERM CELLS."
D010190,D010190,3,3,0,0,0,0,0,0,0,0,0,0,Pancreatic Neoplasms,Pancreatic Neoplasms,"Tumors or cancer of the PANCREAS. Depending on the types of ISLET CELLS present in the tumors, various hormones can be secreted: GLUCAGON from PANCREATIC ALPHA CELLS; INSULIN from PANCREATIC BETA CELLS; and SOMATOSTATIN from the SOMATOSTATIN-SECRETING CELLS. Most are malignant except the insulin-producing tumors (INSULINOMA).","Tumors or cancer of the PANCREAS. Depending on the types of ISLET CELLS present in the tumors, various hormones can be secreted: GLUCAGON from PANCREATIC ALPHA CELLS; INSULIN from PANCREATIC BETA CELLS; and SOMATOSTATIN from the SOMATOSTATIN-SECRETING CELLS. Most are malignant except the insulin-producing tumors (INSULINOMA)."
D010300,D010300,2137,2137,392,392,308,308,84,84,767,767,295,295,Parkinson Disease,Parkinson Disease,"A progressive, degenerative neurologic disease characterized by a TREMOR that is maximal at rest, retropulsion (i.e. a tendency to fall backwards), rigidity, stooped posture, slowness of voluntary movements, and a masklike facial expression. Pathologic features include loss of melanin containing neurons in the substantia nigra and other pigmented nuclei of the brainstem. LEWY BODIES are present in the substantia nigra and locus coeruleus but may also be found in a related condition (LEWY BODY DISEASE, DIFFUSE) characterized by dementia in combination with varying degrees of parkinsonism. (Adams et al., Principles of Neurology, 6th ed, p1059, pp1067-75)","A progressive, degenerative neurologic disease characterized by a TREMOR that is maximal at rest, retropulsion (i.e. a tendency to fall backwards), rigidity, stooped posture, slowness of voluntary movements, and a masklike facial expression. Pathologic features include loss of melanin containing neurons in the substantia nigra and other pigmented nuclei of the brainstem. LEWY BODIES are present in the substantia nigra and locus coeruleus but may also be found in a related condition (LEWY BODY DISEASE, DIFFUSE) characterized by dementia in combination with varying degrees of parkinsonism. (Adams et al., Principles of Neurology, 6th ed, p1059, pp1067-75)"
D010661,D010661,11,11,11,11,4,4,7,7,510,510,247,247,Phenylketonurias,Phenylketonurias,"A group of autosomal recessive disorders marked by a deficiency of the hepatic enzyme PHENYLALANINE HYDROXYLASE or less frequently by reduced activity of DIHYDROPTERIDINE REDUCTASE (i.e., atypical phenylketonuria). Classical phenylketonuria is caused by a severe deficiency of phenylalanine hydroxylase and presents in infancy with developmental delay; SEIZURES; skin HYPOPIGMENTATION; ECZEMA; and demyelination in the central nervous system. (From Adams et al., Principles of Neurology, 6th ed, p952).","A group of autosomal recessive disorders marked by a deficiency of the hepatic enzyme PHENYLALANINE HYDROXYLASE or less frequently by reduced activity of DIHYDROPTERIDINE REDUCTASE (i.e., atypical phenylketonuria). Classical phenylketonuria is caused by a severe deficiency of phenylalanine hydroxylase and presents in infancy with developmental delay; SEIZURES; skin HYPOPIGMENTATION; ECZEMA; and demyelination in the central nervous system. (From Adams et al., Principles of Neurology, 6th ed, p952)."
D011014,D011014,6,6,6,6,6,6,0,0,156,156,60,60,Pneumonia,Pneumonia,Infection of the lung often accompanied by inflammation.,Infection of the lung often accompanied by inflammation.
D011236,D011236,166,166,166,166,25,25,141,141,213,213,74,74,Prediabetic State,Prediabetic State,"The time period before the development of symptomatic diabetes. For example, certain risk factors can be observed in subjects who subsequently develop INSULIN RESISTANCE as in type 2 diabetes (DIABETES MELLITUS, TYPE 2).","The time period before the development of symptomatic diabetes. For example, certain risk factors can be observed in subjects who subsequently develop INSULIN RESISTANCE as in type 2 diabetes (DIABETES MELLITUS, TYPE 2)."
D011471,D011471,6,6,0,0,0,0,0,0,0,0,0,0,Prostatic Neoplasms,Prostatic Neoplasms,Tumors or cancer of the PROSTATE.,Tumors or cancer of the PROSTATE.
D011565,D011565,32,32,32,32,32,32,0,0,1165,1165,442,442,Psoriasis,Psoriasis,"A common genetically determined, chronic, inflammatory skin disease characterized by rounded erythematous, dry, scaling patches. The lesions have a predilection for nails, scalp, genitalia, extensor surfaces, and the lumbosacral region. Accelerated epidermopoiesis is considered to be the fundamental pathologic feature in psoriasis.","A common genetically determined, chronic, inflammatory skin disease characterized by rounded erythematous, dry, scaling patches. The lesions have a predilection for nails, scalp, genitalia, extensor surfaces, and the lumbosacral region. Accelerated epidermopoiesis is considered to be the fundamental pathologic feature in psoriasis."
D012004,D012004,68,68,0,0,0,0,0,0,0,0,0,0,Rectal Neoplasms,Rectal Neoplasms,Tumors or cancer of the RECTUM.,Tumors or cancer of the RECTUM.
D012400,D012400,50,50,50,50,50,50,0,0,0,0,103,103,Rotavirus Infections,Rotavirus Infections,"Infection with any of the rotaviruses. Specific infections include human infantile diarrhea, neonatal calf diarrhea, and epidemic diarrhea of infant mice.","Infection with any of the rotaviruses. Specific infections include human infantile diarrhea, neonatal calf diarrhea, and epidemic diarrhea of infant mice."
D012559,D012559,552,552,552,552,354,354,198,198,0,0,0,0,Schizophrenia,Schizophrenia,"A severe emotional disorder of psychotic depth characteristically marked by a retreat from reality with delusion formation, HALLUCINATIONS, emotional disharmony, and regressive behavior.","A severe emotional disorder of psychotic depth characteristically marked by a retreat from reality with delusion formation, HALLUCINATIONS, emotional disharmony, and regressive behavior."
D012595,D012595,90,90,90,90,90,90,0,0,343,343,115,115,"Scleroderma, Systemic","Scleroderma, Systemic","A chronic multi-system disorder of CONNECTIVE TISSUE. It is characterized by SCLEROSIS in the SKIN, the LUNGS, the HEART, the GASTROINTESTINAL TRACT, the KIDNEYS, and the MUSCULOSKELETAL SYSTEM. Other important features include diseased small BLOOD VESSELS and AUTOANTIBODIES. The disorder is named for its most prominent feature (hard skin), and classified into subsets by the extent of skin thickening: LIMITED SCLERODERMA and DIFFUSE SCLERODERMA.","A chronic multi-system disorder of CONNECTIVE TISSUE. It is characterized by SCLEROSIS in the SKIN, the LUNGS, the HEART, the GASTROINTESTINAL TRACT, the KIDNEYS, and the MUSCULOSKELETAL SYSTEM. Other important features include diseased small BLOOD VESSELS and AUTOANTIBODIES. The disorder is named for its most prominent feature (hard skin), and classified into subsets by the extent of skin thickening: LIMITED SCLERODERMA and DIFFUSE SCLERODERMA."
D012778,D012778,78,78,78,78,62,62,16,16,1668,1668,642,642,Short Bowel Syndrome,Short Bowel Syndrome,"A malabsorption syndrome resulting from extensive operative resection of the SMALL INTESTINE, the absorptive region of the GASTROINTESTINAL TRACT.","A malabsorption syndrome resulting from extensive operative resection of the SMALL INTESTINE, the absorptive region of the GASTROINTESTINAL TRACT."
D013167,D013167,210,210,210,210,210,210,0,0,448,448,155,155,"Spondylitis, Ankylosing","Spondylitis, Ankylosing","A chronic inflammatory condition affecting the axial joints, such as the SACROILIAC JOINT and other intervertebral or costovertebral joints. It occurs predominantly in young males and is characterized by pain and stiffness of joints (ANKYLOSIS) with inflammation at tendon insertions.","A chronic inflammatory condition affecting the axial joints, such as the SACROILIAC JOINT and other intervertebral or costovertebral joints. It occurs predominantly in young males and is characterized by pain and stiffness of joints (ANKYLOSIS) with inflammation at tendon insertions."
D013274,D013274,471,471,388,388,388,388,0,0,4787,4787,1431,1431,Stomach Neoplasms,Stomach Neoplasms,Tumors or cancer of the STOMACH.,Tumors or cancer of the STOMACH.
D013851,D013851,19,19,11,11,11,11,0,0,252,252,93,93,Thinness,Thinness,"A state of insufficient flesh on the body usually defined as having a body weight less than skeletal and physical standards. Depending on age, sex, and genetic background, a BODY MASS INDEX of less than 18.5 is considered as underweight.","A state of insufficient flesh on the body usually defined as having a body weight less than skeletal and physical standards. Depending on age, sex, and genetic background, a BODY MASS INDEX of less than 18.5 is considered as underweight."
D013959,D013959,999,999,999,999,541,541,458,458,2142,2142,748,748,Thyroid Diseases,Thyroid Diseases,Pathological processes involving the THYROID GLAND.,Pathological processes involving the THYROID GLAND.
D013964,D013964,30,30,30,30,30,30,0,0,0,0,46,46,Thyroid Neoplasms,Thyroid Neoplasms,Tumors or cancer of the THYROID GLAND.,Tumors or cancer of the THYROID GLAND.
D014376,D014376,76,76,76,76,76,76,0,0,363,363,136,136,Tuberculosis,Tuberculosis,Any of the infectious diseases of man and other animals caused by species of MYCOBACTERIUM TUBERCULOSIS.,Any of the infectious diseases of man and other animals caused by species of MYCOBACTERIUM TUBERCULOSIS.
D014607,D014607,150,150,150,150,150,150,0,0,267,267,103,103,Uveomeningoencephalitic Syndrome,Uveomeningoencephalitic Syndrome,"A syndrome characterized by bilateral granulomatous UVEITIS with IRITIS and secondary GLAUCOMA, premature ALOPECIA, symmetrical VITILIGO, poliosis circumscripta (a strand of depigmented hair), HEARING DISORDERS, and meningeal signs (neck stiffness and headache). Examination of the cerebrospinal fluid reveals a pattern consistent with MENINGITIS, ASEPTIC. (Adams et al., Principles of Neurology, 6th ed, p748; Surv Ophthalmol 1995 Jan;39(4):265-292)","A syndrome characterized by bilateral granulomatous UVEITIS with IRITIS and secondary GLAUCOMA, premature ALOPECIA, symmetrical VITILIGO, poliosis circumscripta (a strand of depigmented hair), HEARING DISORDERS, and meningeal signs (neck stiffness and headache). Examination of the cerebrospinal fluid reveals a pattern consistent with MENINGITIS, ASEPTIC. (Adams et al., Principles of Neurology, 6th ed, p748; Surv Ophthalmol 1995 Jan;39(4):265-292)"
D015179,D015179,2228,2228,1773,1773,1697,1697,76,76,4458,4458,1365,1365,Colorectal Neoplasms,Colorectal Neoplasms,Tumors or cancer of the COLON or the RECTUM or both. Risk factors for colorectal cancer include chronic ULCERATIVE COLITIS; FAMILIAL POLYPOSIS COLI; exposure to ASBESTOS; and irradiation of the CERVIX UTERI.,Tumors or cancer of the COLON or the RECTUM or both. Risk factors for colorectal cancer include chronic ULCERATIVE COLITIS; FAMILIAL POLYPOSIS COLI; exposure to ASBESTOS; and irradiation of the CERVIX UTERI.
D015209,D015209,38,38,38,38,38,38,0,0,887,887,306,306,"Cholangitis, Sclerosing","Cholangitis, Sclerosing","Chronic inflammatory disease of the BILIARY TRACT. It is characterized by fibrosis and hardening of the intrahepatic and extrahepatic biliary ductal systems leading to bile duct strictures, CHOLESTASIS, and eventual BILIARY CIRRHOSIS.","Chronic inflammatory disease of the BILIARY TRACT. It is characterized by fibrosis and hardening of the intrahepatic and extrahepatic biliary ductal systems leading to bile duct strictures, CHOLESTASIS, and eventual BILIARY CIRRHOSIS."
D015212,D015212,915,915,915,915,605,605,310,310,5079,5079,1501,1501,Inflammatory Bowel Diseases,Inflammatory Bowel Diseases,"Chronic, non-specific inflammation of the GASTROINTESTINAL TRACT. Etiology may be genetic or environmental. This term includes CROHN DISEASE and ULCERATIVE COLITIS.","Chronic, non-specific inflammation of the GASTROINTESTINAL TRACT. Etiology may be genetic or environmental. This term includes CROHN DISEASE and ULCERATIVE COLITIS."
D015464,D015464,3,3,0,0,0,0,0,0,0,0,0,0,"Leukemia, Myelogenous, Chronic, BCR-ABL Positive","Leukemia, Myelogenous, Chronic, BCR-ABL Positive","Clonal hematopoetic disorder caused by an acquired genetic defect in PLURIPOTENT STEM CELLS. It starts in MYELOID CELLS of the bone marrow, invades the blood and then other organs. The condition progresses from a stable, more indolent, chronic phase (LEUKEMIA, MYELOID, CHRONIC PHASE) lasting up to 7 years, to an advanced phase composed of an accelerated phase (LEUKEMIA, MYELOID, ACCELERATED PHASE) and BLAST CRISIS.","Clonal hematopoetic disorder caused by an acquired genetic defect in PLURIPOTENT STEM CELLS. It starts in MYELOID CELLS of the bone marrow, invades the blood and then other organs. The condition progresses from a stable, more indolent, chronic phase (LEUKEMIA, MYELOID, CHRONIC PHASE) lasting up to 7 years, to an advanced phase composed of an accelerated phase (LEUKEMIA, MYELOID, ACCELERATED PHASE) and BLAST CRISIS."
D015497,D015497,79,79,79,79,77,77,2,2,818,818,272,272,HIV-1,HIV-1,The type species of LENTIVIRUS and the etiologic agent of AIDS. It is characterized by its cytopathic effect and affinity for the T4-lymphocyte.,The type species of LENTIVIRUS and the etiologic agent of AIDS. It is characterized by its cytopathic effect and affinity for the T4-lymphocyte.
D015518,D015518,8,8,8,8,8,8,0,0,1530,1530,625,625,Rett Syndrome,Rett Syndrome,"An inherited neurological developmental disorder that is associated with X-LINKED INHERITANCE and may be lethal in utero to hemizygous males. The affected female is normal until the age of 6-25 months when progressive loss of voluntary control of hand movements and communication skills; ATAXIA; SEIZURES; autistic behavior; intermittent HYPERVENTILATION; and HYPERAMMONEMIA appear. (From Menkes, Textbook of Child Neurology, 5th ed, p199)","An inherited neurological developmental disorder that is associated with X-LINKED INHERITANCE and may be lethal in utero to hemizygous males. The affected female is normal until the age of 6-25 months when progressive loss of voluntary control of hand movements and communication skills; ATAXIA; SEIZURES; autistic behavior; intermittent HYPERVENTILATION; and HYPERAMMONEMIA appear. (From Menkes, Textbook of Child Neurology, 5th ed, p199)"
D015658,D015658,30,30,30,30,30,30,0,0,0,0,109,109,HIV Infections,HIV Infections,"Includes the spectrum of human immunodeficiency virus infections that range from asymptomatic seropositivity, thru AIDS-related complex (ARC), to acquired immunodeficiency syndrome (AIDS).","Includes the spectrum of human immunodeficiency virus infections that range from asymptomatic seropositivity, thru AIDS-related complex (ARC), to acquired immunodeficiency syndrome (AIDS)."
D015673,D015673,84,84,84,84,84,84,0,0,0,0,108,108,"Fatigue Syndrome, Chronic","Fatigue Syndrome, Chronic","A syndrome characterized by persistent or recurrent fatigue, diffuse musculoskeletal pain, sleep disturbances, and subjective cognitive impairment of 6 months duration or longer. Symptoms are not caused by ongoing exertion; are not relieved by rest; and result in a substantial reduction of previous levels of occupational, educational, social, or personal activities. Minor alterations of immune, neuroendocrine, and autonomic function may be associated with this syndrome. There is also considerable overlap between this condition and FIBROMYALGIA. (From Semin Neurol 1998;18(2):237-42; Ann Intern Med 1994 Dec 15;121(12): 953-9)","A syndrome characterized by persistent or recurrent fatigue, diffuse musculoskeletal pain, sleep disturbances, and subjective cognitive impairment of 6 months duration or longer. Symptoms are not caused by ongoing exertion; are not relieved by rest; and result in a substantial reduction of previous levels of occupational, educational, social, or personal activities. Minor alterations of immune, neuroendocrine, and autonomic function may be associated with this syndrome. There is also considerable overlap between this condition and FIBROMYALGIA. (From Semin Neurol 1998;18(2):237-42; Ann Intern Med 1994 Dec 15;121(12): 953-9)"
D016360,D016360,84,84,84,84,41,41,43,43,1542,1542,611,611,Clostridium difficile,Clostridium difficile,"A common inhabitant of the colon flora in human infants and sometimes in adults. It produces a toxin that causes pseudomembranous enterocolitis (ENTEROCOLITIS, PSEUDOMEMBRANOUS) in patients receiving antibiotic therapy.","A common inhabitant of the colon flora in human infants and sometimes in adults. It produces a toxin that causes pseudomembranous enterocolitis (ENTEROCOLITIS, PSEUDOMEMBRANOUS) in patients receiving antibiotic therapy."
D016480,D016480,92,92,92,92,0,0,92,92,0,0,0,0,Helicobacter pylori,Helicobacter pylori,"A spiral bacterium active as a human gastric pathogen. It is a gram-negative, urease-positive, curved or slightly spiral organism initially isolated in 1982 from patients with lesions of gastritis or peptic ulcers in Western Australia. Helicobacter pylori was originally classified in the genus CAMPYLOBACTER, but RNA sequencing, cellular fatty acid profiles, growth patterns, and other taxonomic characteristics indicate that the micro-organism should be included in the genus HELICOBACTER. It has been officially transferred to Helicobacter gen. nov. (see Int J Syst Bacteriol 1989 Oct;39(4):297-405).","A spiral bacterium active as a human gastric pathogen. It is a gram-negative, urease-positive, curved or slightly spiral organism initially isolated in 1982 from patients with lesions of gastritis or peptic ulcers in Western Australia. Helicobacter pylori was originally classified in the genus CAMPYLOBACTER, but RNA sequencing, cellular fatty acid profiles, growth patterns, and other taxonomic characteristics indicate that the micro-organism should be included in the genus HELICOBACTER. It has been officially transferred to Helicobacter gen. nov. (see Int J Syst Bacteriol 1989 Oct;39(4):297-405)."
D016640,D016640,98,98,98,98,98,98,0,0,1765,1765,709,709,"Diabetes, Gestational","Diabetes, Gestational",Diabetes mellitus induced by PREGNANCY but resolved at the end of pregnancy. It does not include previously diagnosed diabetics who become pregnant (PREGNANCY IN DIABETICS). Gestational diabetes usually develops in late pregnancy when insulin antagonistic hormones peaks leading to INSULIN RESISTANCE; GLUCOSE INTOLERANCE; and HYPERGLYCEMIA.,Diabetes mellitus induced by PREGNANCY but resolved at the end of pregnancy. It does not include previously diagnosed diabetics who become pregnant (PREGNANCY IN DIABETICS). Gestational diabetes usually develops in late pregnancy when insulin antagonistic hormones peaks leading to INSULIN RESISTANCE; GLUCOSE INTOLERANCE; and HYPERGLYCEMIA.
D016776,D016776,48,48,48,48,48,48,0,0,0,0,34,34,Blastocystis Infections,Blastocystis Infections,"Infections with organisms of the genus BLASTOCYSTIS. The species B. hominis is responsible for most infections. Parasitologic surveys have generally found small numbers of this species in human stools, but higher positivity rates and organism numbers in AIDS patients and other immunosuppressed patients (IMMUNOCOMPROMISED HOST). Symptoms include ABDOMINAL PAIN; DIARRHEA; CONSTIPATION; VOMITING; and FATIGUE.","Infections with organisms of the genus BLASTOCYSTIS. The species B. hominis is responsible for most infections. Parasitologic surveys have generally found small numbers of this species in human stools, but higher positivity rates and organism numbers in AIDS patients and other immunosuppressed patients (IMMUNOCOMPROMISED HOST). Symptoms include ABDOMINAL PAIN; DIARRHEA; CONSTIPATION; VOMITING; and FATIGUE."
D016918,D016918,32,32,32,32,32,32,0,0,0,0,93,93,"Arthritis, Reactive","Arthritis, Reactive","An aseptic, inflammatory arthritis developing secondary to a primary extra-articular infection, most typically of the GASTROINTESTINAL TRACT or UROGENITAL SYSTEM. The initiating trigger pathogens are usually SHIGELLA; SALMONELLA; YERSINIA; CAMPYLOBACTER; or CHLAMYDIA TRACHOMATIS. Reactive arthritis is strongly associated with HLA-B27 ANTIGEN.","An aseptic, inflammatory arthritis developing secondary to a primary extra-articular infection, most typically of the GASTROINTESTINAL TRACT or UROGENITAL SYSTEM. The initiating trigger pathogens are usually SHIGELLA; SALMONELLA; YERSINIA; CAMPYLOBACTER; or CHLAMYDIA TRACHOMATIS. Reactive arthritis is strongly associated with HLA-B27 ANTIGEN."
D018256,D018256,55,55,20,20,0,0,20,20,0,0,0,0,Adenomatous Polyps,Adenomatous Polyps,"Benign neoplasms derived from glandular epithelium. (From Stedman, 25th ed)","Benign neoplasms derived from glandular epithelium. (From Stedman, 25th ed)"
D019337,D019337,420,420,420,420,326,326,94,94,1851,1851,567,567,Hematologic Neoplasms,Hematologic Neoplasms,"Neoplasms located in the blood and blood-forming tissue (the bone marrow and lymphatic tissue). The commonest forms are the various types of LEUKEMIA, of LYMPHOMA, and of the progressive, life-threatening forms of the MYELODYSPLASTIC SYNDROMES.","Neoplasms located in the blood and blood-forming tissue (the bone marrow and lymphatic tissue). The commonest forms are the various types of LEUKEMIA, of LYMPHOMA, and of the progressive, life-threatening forms of the MYELODYSPLASTIC SYNDROMES."
D020187,D020187,37,37,37,37,16,16,21,21,541,541,185,185,REM Sleep Behavior Disorder,REM Sleep Behavior Disorder,"A disorder characterized by episodes of vigorous and often violent motor activity during REM sleep (SLEEP, REM). The affected individual may inflict self injury or harm others, and is difficult to awaken from this condition. Episodes are usually followed by a vivid recollection of a dream that is consistent with the aggressive behavior. This condition primarily affects adult males. (From Adams et al., Principles of Neurology, 6th ed, p393)","A disorder characterized by episodes of vigorous and often violent motor activity during REM sleep (SLEEP, REM). The affected individual may inflict self injury or harm others, and is difficult to awaken from this condition. Episodes are usually followed by a vivid recollection of a dream that is consistent with the aggressive behavior. This condition primarily affects adult males. (From Adams et al., Principles of Neurology, 6th ed, p393)"
D020345,D020345,1135,1135,1068,1068,15,15,1053,1053,205,205,91,91,"Enterocolitis, Necrotizing","Enterocolitis, Necrotizing",ENTEROCOLITIS with extensive ulceration (ULCER) and NECROSIS. It is observed primarily in LOW BIRTH WEIGHT INFANT.,ENTEROCOLITIS with extensive ulceration (ULCER) and NECROSIS. It is observed primarily in LOW BIRTH WEIGHT INFANT.
D020528,D020528,15,15,0,0,0,0,0,0,0,0,0,0,"Multiple Sclerosis, Chronic Progressive","Multiple Sclerosis, Chronic Progressive","A form of multiple sclerosis characterized by a progressive deterioration in neurologic function which is in contrast to the more typical relapsing remitting form. If the clinical course is free of distinct remissions, it is referred to as primary progressive multiple sclerosis. When the progressive decline is punctuated by acute exacerbations, it is referred to as progressive relapsing multiple sclerosis. The term secondary progressive multiple sclerosis is used when relapsing remitting multiple sclerosis evolves into the chronic progressive form. (From Ann Neurol 1994;36 Suppl:S73-S79; Adams et al., Principles of Neurology, 6th ed, pp903-914)","A form of multiple sclerosis characterized by a progressive deterioration in neurologic function which is in contrast to the more typical relapsing remitting form. If the clinical course is free of distinct remissions, it is referred to as primary progressive multiple sclerosis. When the progressive decline is punctuated by acute exacerbations, it is referred to as progressive relapsing multiple sclerosis. The term secondary progressive multiple sclerosis is used when relapsing remitting multiple sclerosis evolves into the chronic progressive form. (From Ann Neurol 1994;36 Suppl:S73-S79; Adams et al., Principles of Neurology, 6th ed, pp903-914)"
D020529,D020529,62,62,0,0,0,0,0,0,0,0,0,0,"Multiple Sclerosis, Relapsing-Remitting","Multiple Sclerosis, Relapsing-Remitting","The most common clinical variant of MULTIPLE SCLEROSIS, characterized by recurrent acute exacerbations of neurologic dysfunction followed by partial or complete recovery. Common clinical manifestations include loss of visual (see OPTIC NEURITIS), motor, sensory, or bladder function. Acute episodes of demyelination may occur at any site in the central nervous system, and commonly involve the optic nerves, spinal cord, brain stem, and cerebellum. (Adams et al., Principles of Neurology, 6th ed, pp903-914)","The most common clinical variant of MULTIPLE SCLEROSIS, characterized by recurrent acute exacerbations of neurologic dysfunction followed by partial or complete recovery. Common clinical manifestations include loss of visual (see OPTIC NEURITIS), motor, sensory, or bladder function. Acute episodes of demyelination may occur at any site in the central nervous system, and commonly involve the optic nerves, spinal cord, brain stem, and cerebellum. (Adams et al., Principles of Neurology, 6th ed, pp903-914)"
D024821,D024821,72,72,64,64,34,34,30,30,1250,1250,477,477,Metabolic Syndrome,Metabolic Syndrome,A cluster of symptoms that are risk factors for CARDIOVASCULAR DISEASES and TYPE 2 DIABETES MELLITUS. The major components of metabolic syndrome include ABDOMINAL OBESITY; atherogenic DYSLIPIDEMIA; HYPERTENSION; HYPERGLYCEMIA; INSULIN RESISTANCE; a proinflammatory state; and a prothrombotic (THROMBOSIS) state.,A cluster of symptoms that are risk factors for CARDIOVASCULAR DISEASES and TYPE 2 DIABETES MELLITUS. The major components of metabolic syndrome include ABDOMINAL OBESITY; atherogenic DYSLIPIDEMIA; HYPERTENSION; HYPERGLYCEMIA; INSULIN RESISTANCE; a proinflammatory state; and a prothrombotic (THROMBOSIS) state.
D025241,D025241,27,27,27,27,27,27,0,0,1608,1608,571,571,Spondylarthritis,Spondylarthritis,"Inflammation of the joints of the SPINE, the intervertebral articulations.","Inflammation of the joints of the SPINE, the intervertebral articulations."
D035061,D035061,948,948,644,644,640,640,4,4,1645,1645,620,620,Control Groups,Control Groups,Groups that serve as a standard for comparison in experimental studies. They are similar in relevant characteristics to the experimental group but do not receive the experimental intervention.,Groups that serve as a standard for comparison in experimental studies. They are similar in relevant characteristics to the experimental group but do not receive the experimental intervention.
D037841,D037841,132,132,132,132,131,131,1,1,2064,2064,810,810,Pregnant Women,Pregnant Women,"Human females who are pregnant, as cultural, psychological, or sociological entities.","Human females who are pregnant, as cultural, psychological, or sociological entities."
D042882,D042882,82,82,82,82,0,0,82,82,0,0,0,0,Gallstones,Gallstones,"Solid crystalline precipitates in the BILIARY TRACT, usually formed in the GALLBLADDER, resulting in the condition of CHOLELITHIASIS. Gallstones, derived from the BILE, consist mainly of calcium, cholesterol, or bilirubin.","Solid crystalline precipitates in the BILIARY TRACT, usually formed in the GALLBLADDER, resulting in the condition of CHOLELITHIASIS. Gallstones, derived from the BILE, consist mainly of calcium, cholesterol, or bilirubin."
D043183,D043183,1996,1996,1967,1967,1002,1002,965,965,2636,2636,900,900,Irritable Bowel Syndrome,Irritable Bowel Syndrome,"A disorder with chronic or recurrent colonic symptoms without a clearcut etiology. This condition is characterized by chronic or recurrent ABDOMINAL PAIN, bloating, MUCUS in FECES, and an erratic disturbance of DEFECATION.","A disorder with chronic or recurrent colonic symptoms without a clearcut etiology. This condition is characterized by chronic or recurrent ABDOMINAL PAIN, bloating, MUCUS in FECES, and an erratic disturbance of DEFECATION."
D044342,D044342,65,65,0,0,0,0,0,0,0,0,0,0,Malnutrition,Malnutrition,An imbalanced nutritional status resulting from insufficient intake of nutrients to meet normal physiological requirement.,An imbalanced nutritional status resulting from insufficient intake of nutrients to meet normal physiological requirement.
D050031,D050031,35,35,35,35,35,35,0,0,1172,1172,413,413,Hashimoto Disease,Hashimoto Disease,"Chronic autoimmune thyroiditis, characterized by the presence of high serum thyroid AUTOANTIBODIES; GOITER; and HYPOTHYROIDISM.","Chronic autoimmune thyroiditis, characterized by the presence of high serum thyroid AUTOANTIBODIES; GOITER; and HYPOTHYROIDISM."
D050177,D050177,140,140,100,100,89,89,11,11,340,340,119,119,Overweight,Overweight,"A status with BODY WEIGHT that is above certain standard of acceptable or desirable weight. In the scale of BODY MASS INDEX, overweight is defined as having a BMI of 25.0-29.9 kg/m2. Overweight may or may not be due to increases in body fat (ADIPOSE TISSUE), hence overweight does not equal ""over fat"".","A status with BODY WEIGHT that is above certain standard of acceptable or desirable weight. In the scale of BODY MASS INDEX, overweight is defined as having a BMI of 25.0-29.9 kg/m2. Overweight may or may not be due to increases in body fat (ADIPOSE TISSUE), hence overweight does not equal ""over fat""."
D050197,D050197,27,27,27,27,27,27,0,0,218,218,76,76,Atherosclerosis,Atherosclerosis,A thickening and loss of elasticity of the walls of ARTERIES that occurs with formation of ATHEROSCLEROTIC PLAQUES within the ARTERIAL INTIMA.,A thickening and loss of elasticity of the walls of ARTERIES that occurs with formation of ATHEROSCLEROTIC PLAQUES within the ARTERIAL INTIMA.
D054198,D054198,406,406,406,406,353,353,53,53,2144,2144,824,824,Precursor Cell Lymphoblastic Leukemia-Lymphoma,Precursor Cell Lymphoblastic Leukemia-Lymphoma,A neoplasm characterized by abnormalities of the lymphoid cell precursors leading to excessive lymphoblasts in the marrow and other organs. It is the most common cancer in children and accounts for the vast majority of all childhood leukemias.,A neoplasm characterized by abnormalities of the lymphoid cell precursors leading to excessive lymphoblasts in the marrow and other organs. It is the most common cancer in children and accounts for the vast majority of all childhood leukemias.
D054323,D054323,7,7,7,7,6,6,1,1,130,130,49,49,Shiga-Toxigenic Escherichia coli,Shiga-Toxigenic Escherichia coli,"Strains of ESCHERICHIA COLI with the ability to produce at least one or more of at least two antigenically distinct, usually bacteriophage-mediated cytotoxins: SHIGA TOXIN 1 and SHIGA TOXIN 2. These bacteria can cause severe disease in humans including bloody DIARRHEA and HEMOLYTIC UREMIC SYNDROME.","Strains of ESCHERICHIA COLI with the ability to produce at least one or more of at least two antigenically distinct, usually bacteriophage-mediated cytotoxins: SHIGA TOXIN 1 and SHIGA TOXIN 2. These bacteria can cause severe disease in humans including bloody DIARRHEA and HEMOLYTIC UREMIC SYNDROME."
D055113,D055113,25,25,25,25,9,9,16,16,360,360,141,141,Chronic Periodontitis,Chronic Periodontitis,"Chronic inflammation and loss of PERIODONTIUM that is associated with the amount of DENTAL PLAQUE or DENTAL CALCULUS present. Chronic periodontitis occurs mostly in adults and was called adult periodontitis, but this disease can appear in young people.","Chronic inflammation and loss of PERIODONTIUM that is associated with the amount of DENTAL PLAQUE or DENTAL CALCULUS present. Chronic periodontitis occurs mostly in adults and was called adult periodontitis, but this disease can appear in young people."
D055752,D055752,3,3,0,0,0,0,0,0,0,0,0,0,Small Cell Lung Carcinoma,Small Cell Lung Carcinoma,A form of highly malignant lung cancer that is composed of small ovoid cells (SMALL CELL CARCINOMA).,A form of highly malignant lung cancer that is composed of small ovoid cells (SMALL CELL CARCINOMA).
D056865,D056865,24,24,0,0,0,0,0,0,0,0,0,0,Ideal Body Weight,Ideal Body Weight,"Expected weight of a healthy normal individual based on age, sex, and height. Thus, a malnourished person would weigh less than their ideal body weight.","Expected weight of a healthy normal individual based on age, sex, and height. Thus, a malnourished person would weigh less than their ideal body weight."
D058246,D058246,56,56,56,56,56,56,0,0,211,211,92,92,Prehypertension,Prehypertension,"Blood pressure levels that are between normotension and hypertension. Individuals with prehypertension are at a higher risk for developing cardiovascular diseases. Generally, prehypertension is defined as SYSTOLIC PRESSURE of 131-139 mm Hg and/or DIASTOLIC PRESSURE of 81-89 when the optimal is 120/80 mm Hg. For diabetics and other metabolism diseases the prehypertension is around 110-129/70-79 mm Hg.","Blood pressure levels that are between normotension and hypertension. Individuals with prehypertension are at a higher risk for developing cardiovascular diseases. Generally, prehypertension is defined as SYSTOLIC PRESSURE of 131-139 mm Hg and/or DIASTOLIC PRESSURE of 81-89 when the optimal is 120/80 mm Hg. For diabetics and other metabolism diseases the prehypertension is around 110-129/70-79 mm Hg."
D060825,D060825,62,62,62,62,62,62,0,0,0,0,77,77,Cognitive Dysfunction,Cognitive Dysfunction,Diminished or impaired mental and/or intellectual function.,Diminished or impaired mental and/or intellectual function.
D065290,D065290,290,290,0,0,0,0,0,0,0,0,0,0,Acute-On-Chronic Liver Failure,Acute-On-Chronic Liver Failure,"Sudden liver failure in the presence of underlying compensated chronic LIVER DISEASE (e.g., LIVER CIRRHOSIS; HEPATITIS; and liver injury and failure) due to a precipitating acute hepatic insult.","Sudden liver failure in the presence of underlying compensated chronic LIVER DISEASE (e.g., LIVER CIRRHOSIS; HEPATITIS; and liver injury and failure) due to a precipitating acute hepatic insult."
D065626,D065626,728,728,307,307,226,226,81,81,1065,1065,365,365,Non-alcoholic Fatty Liver Disease,Non-alcoholic Fatty Liver Disease,Fatty liver finding without excessive ALCOHOL CONSUMPTION.,Fatty liver finding without excessive ALCOHOL CONSUMPTION.
